"a" = (/turf,/area)
"b" = (/turf/blue,/area)
"c" = (/obj/table,/turf,/area)
"d" = (/obj/gun,/turf,/area)

(1,1,1) = {"
bbbbbbbbbb
baaaaaaacb
baaaaadaab
baaaaaaaab
baaaaaaaab
baaaaaaaab
baaaaaaaab
baaaaaaaab
baaaaaaaab
bbbbbbbbbb
"}

(1,1,2) = {"
baaaaaaaab
abaaaaaaba
aabaaaabaa
aaabaabaaa
aaaabbaaaa
aaaabbaaaa
aaabaabaaa
aabaaaabaa
abaaaaaaba
baaaaaaaab
"}

(1,1,3) = {"
aaaabbaaaa
aaabaabaaa
aabaaaabaa
abaaaaaaba
baaaaaaaab
baaaaaaaab
abaaaaaaba
aabaaaabaa
aaabaabaaa
aaaabbaaaa
"}
